

R 1200 1000

NO ./textures/selected_contour.xpm

SO ./textures/unselected_contour.xpm
WE ./textures/remote.xpm
EA ./textures/menu.xpm

S ./textures/off_button.xpm

F 220    ,        100,0

C 5,30,0


1 1 1 1 1 1 1 1 1 1 1 1 1 1 1 1 1 1 1 1 1 1 1 1 1 1 1 1 1 1 1 1 1 1 1 1 1 1 1 1 1
1 0 0 0 0 0 0 0 0 0 1 1 0 0 0 0 0 0 0 0   0   0 0 0 0 0 0 0 0 0   0 0 0 0 0 0 0 1
1 0 1 1 0 0 0 0 0 1 1 1 0 0 0 0 0     0 2 0 0 0   E 0 0 0 0 0 2 0 0 0 0 1 0 0 0 1
1 0 0 1 0 0 0 0 0 0 0 0 0 0 0 0 0 0 0   0 0 0 0   0 0 0 0 0   0 0 0 0 0 1 0 0 0 1
1 0 1 1 0 0 0 0 0 1 1 1 0 0 0 0 0 0 0   0 0 0 0   0 0 0   0 0 0 0 0 0 0 1 0 0 0 1
1 0 0 0 0 0 0 0 0 0 1 1 0 0 0 0   0 1 1   1 0 1   1 1 0 0 0 1 1 1 0 1 1 1 0 0 0 1
1 1 1 1 0 1 1 1 1 1 1 1 1 1 0   1 1 1 0 0 0   0 0   0 0 1 1 1 0 0 0 0 0 1 0 0 0 1
1 1 1 1 0 1 1 1 1 1 1 1 1 1 0 1 1 1 0 1 0 1     0   0 0 1 1 1 0 1 0 1 0 1 0 0 0 1
1 1 0 0 0 0 0 0 1 1 0 1 0 1   0 1 1 1 0 0 0 0   0 0   0 1 1 1 0 0 0 0 0 1 0 0 0 1
1 0 0 0 2 0 0 0 0 0 0 0 0   0 0 0 1 1   0 0 0 0 0 0   0 0 1 1 0 0 0 0 0 1 0 0 0 1
1 0 0 0 0 0 0 0 0 0 0 0 0 0 0 0 1 1   0 1 0 1 0 0 0   0   1 1 0 1 0 1 0 1 0 0 0 1
1 1 0 0 0 0 0   0 1 1 0 1 0 1 0 1 1 1   1 1   0 1 1 1 0 1 1 1 1 1 0 1 1 1 0 0 0 1
1 1 1 1 0 1     1 1 1 1 1 1 0 1 0 1 1 1 1 1 0 1 1 1   0 1 1 1 1 1 0 1 1 1 0 0 0 1
1 1 1 1 1 1 1 1 1 1 1 1 1 1 1 1 1 1 1 1 1 1 1 1 1 1 1 1 1 1 1 1 1 1 1 1 1 1 1 1 1
